NO /Users/mait-taj/Desktop/cub_3D/textures/img-adv--500-employees.PNG                   
F 20,      100      ,     90
EA    /Users/mait-taj/Desktop/cub_3D/textures/img-adv--500-employees.PNG                   
SO /Users/mait-taj/Desktop/cub_3D/textures/img-adv--500-employees.PNG                                               
C  225,                00000000000000000000, 0
WE /Users/mait-taj/Desktop/cub_3D/textures/img-adv--500-employees.PNG                 


               

1111111111111111111111111111  
     10000110001100000000001 
1111111111  111111111111111 111
 11 1011001101110000000000010001 1   1
10010000000000000000000111111111                 
111111111011000001110000000000001    
100000000011000001110111111111111           
1111W111111111011100000010001                            
11110111111111011101010010001                                    
11000000110101011000000100011
10000000000000001100000010001
 10000000000000001101010010001
1100000111010101111101111010111               
11110111 1110101 101111010001
    11111111111111111111111111111
    101 101
     1  1111111111111111111111111111111
11111111 1111111 1111111 1111

 
