F    029,                        75   ,19
NO ./textures/eagle.png
SO ./textures/bluestone.png
C 225,30,0
EA ./textures/wall_1.png
WE ./textures/wood.png







1111111111111111111111111111111111111111111111111111 
 1000000000000000000010000000000000000000011111111111
110000000000000000000000000000000000000000000000000011111
10000000000000000000000111100000000000000000000000000001
10000000000000000000000000001111111000000000000000011111
1000000000000000000000000000000000000000000000000001
1000000000000000W00000000000000000000000000000000001     11
100000000001000000000000000000000000000000000000011 1111101
11111111111111111111111111111111111111111111111111111111111
111111111111111111111111111111111111111111111111111              
    







               