F    029,                        75   ,19
NO ./textures/grung.png
SO ./textures/darkmetal.png
C 225,255,255
EA ./textures/wall_3.png
WE ./textures/door.png

      1
     101
    10001
   1000001
  100101001
 10011011001
1001 101 1001
1001 101 1001
 10011011001
  100101001
   1000001
    10001
     101
     101
    10001
   1000001
  100101001
 10011011001
1001 101 1001
1001 101 1001
 10011011001
  100101001
   1000001
    10001
     101
     101
    10001
   1000001
  100101001
 10011011001
1001 101 1001
1001 101 1001
 10011011001
  100101001
   1000001
    10001
     101
     101
    10001
   1000001
  100101001
 10011011001
1001 101 1001
1001 101 1001
 10011011001
  100101001
   1000001
    10001
     101
     101
    10001
   1000001
  100101001
 10011011001
1001 101 1001
1001 101 1001
 10011011001
  100101001
   1000001
    10001
     1N1
      1
      1