NO ./textures/eagle.png
SO ./textures/bluestone.png
WE ./textures/wood.png
EA ./textures/wall_1.png

F 220, 100,0
C 225,30,0



1111111111111111111111111111111111111111111111111111
10000000000000000000E0000000000000000000000000000001
1000000000000000000000000000000000000000000000000001
1000000000000000000000000000000000000000000000000001
1000000000000000000000000000000000000000000000000001
1000000000000000000000000000000000000000000000000001
1000000000000000000000000000000000000000000000000001
1000000000000000000000000000000000000000000000000001
1111111111111111111111111111111111111111111111111111