SO ./textures/bluestone.png
NO ./textures/eagle.png
EA ./textures/wall_1.png
WE ./textures/wood.png

F 222, 219, 185
C 220, 245, 169
        111111111111111111111111
        1000000000110000000000001
        101100000001000000000S001
        1001000000000000000000001
111111111011000000010000000000001
100000000011000001110111111111111
11110111111110011100000010001    
11000000111101011100000010001    
10000000000000000000000000001    
10000000000000001101010010001    
11000001110101011111011110111    
11110111 111010101 1111010001    
11111111 111111111 1111111111    