NO ./textures/bluestone.png
SO ./textures/bluestone.png
WE ./textures/bluestone.png
EA ./textures/bluestone.png

F 220,100,0
C 225,30,0

11111111 1111111 111111111
 100001   10S01   1000001
  1001     101     10001
 100001   10001   1000001
10000001 1000001 100000001
100000001000000010000000001
 1010101010101010101010101
  10000000000000000000001
   100000000000000000001
    1000000000000000001
     10000100100100001
      100000000000001
       1000100010001
        101 101 101
         1   1   1 