NO ./textures/eagle.png
SO ./textures/eagle.png
WE ./textures/eagle.png
EA ./textures/eagle.png

F 179, 173, 104              
C 170, 255, 253

11111111111111111111111111111    
10000000000000000000000000001       
10000000001111110000000000001                            
1000N000001111110000000000001     
10000000000000000000000000001      
1111111111111111111111111111    