NO ./textures/eagle.png
SO ./textures/bluestone.png
WE ./textures/grung.png
EA ./textures/wall_1.png

F 179, 173, 104              
C 170, 255, 253

11111111111111111111111111111    
10000000000000000000000000001
10000000000000000000000000001       
10000000001000000000100000001       
10000000001000000000100000001       
10000000001000000000100000001       
10000000001000000000000000001                            
1000N000000000000000000000001     
10000000000000000000000000001      
1111111111111111111111111111    