NO ./textures/eagle.png
SO ./textures/eagle.png
WE ./textures/eagle.png
EA ./textures/eagle.png

F 255,         100,0
C 225,30,0

11111111111111111111111111111    
10000000000000000000000000001
10000000001111110000000000001                          
1000S000001111110000000000001 
10000000000000000000000000001
1111111111111111111111111111    